America East Conference:
Avery Banks - Bryant University - OPP (PSVA)
Tessa Boomhour - Bryant University - MB/OPP (L2)
Addison Lefeld - University of Maryland, Baltimore County - OPP (AVC)
Jennifer Curran - University of New Hampshire - MB (Sports Performance)

American Athletic Conference:
Brylee Pinkston - University of Alabama at Birmingham - Libero/DS (Lower Alabama)
Jordan Redd - University of Alabama at Birmingham - OPP/OH (KC Voltage)
McKenna Willard - University of Alabama at Birmingham - Setter (A5)
Kennedy Crider - East Carolina University - OH/MB (Austin Performance)
Ella Godeaux - East Carolina University - Libero/DS (Sports Performance)
Anarela Mejias - East Carolina University - OH/OPP (Alliance)
Melanie Pinales - East Carolina University - MB (East Coast Crush)
Ava Vanderklok - Florida Atlantic University - Libero/DS (Tennessee Performance)
Kaylin Bailey - University of Memphis - Libero/DS (Houston Juniors)
Sara Buoni - University of Memphis - OPP/OH (M2)
Kaylie Davis - University of Memphis - OH (Drive Nation)
Keegan Flowers - University of Memphis - MB (TAV)
Micah Rusher - University of Memphis - MB (TAV Houston)
Gabbie Skopljak - University of North Texas - MB/OPP (Dallas Skyline)
Audie Caban - Rice University - MB (WAVE)
Julia Cernich - Rice University - OH/OPP (AVC)
Mia Furoyama - Rice University - Libero/DS (Hawaii Next Level)
Olivia Greenwood - Rice University - OPP (WAVE)
Mazzy Johnson - Rice University - OH/OPP (Austin Juniors)
Gwen Forsha - University of South Florida - OH (Tennessee Performance)
Adelyn Chang - Temple University - Setter (AZ Storm)
Corina Barrera - University of Texas at San Antonio - OH/DS (San Antonio Juniors)
Carsyn Simmons - University of Texas at San Antonio - OPP (Carolina Union)
Erika Larson - Tulane University - Setter (NC Volleyball Academy)
McKenna Gobin - University of Tulsa - MB (South Texas Volleyball Academy)
Leeanna Hamilton - University of Tulsa - OPP (San Antonio Juniors)
Joelle Kelly - University of Tulsa - MB (Dallas Premier)
Deidra Doeden - Wichita State University - MB (Salty Volleyball Club)
Autumn Popp - Wichita State University - Setter (Shockwave)
Kela Williams - Wichita State University - Libero/DS (208 Volleyball Club)

Atlantic 10 Conference:
Nora Breitwieser - University of Dayton - Libero/DS (Metro)
Grace Goodyke - University of Dayton - OH/OPP (FaR Out)
Hannah Herrick - University of Dayton - OH (Sports Performance)
Edie Miller - University of Dayton - Libero/DS (Iowa Rockets)
Ainsley Wilson - University of Dayton - MB (1st Alliance)
Kinley Young - University of Dayton - MB (Boiler Juniors)
Mia Will - Duquesne University - OH/OPP (Triangle)
Caroline Apergis - Fordham University - Libero/DS (Metro)
Caitlin Crino - Fordham University - Setter (Tribe)
Maia Raleigh - Fordham University - Setter (Dallas Skyline)
Josie Hellyer - George Mason University - Setter (Kokoro)
Macy Monson - George Mason University - MB (Northern Lights)
Sophia Blank - Loyola University Chicago - MB (Sports Performance)
Lilia Decker - Loyola University Chicago - OH (WAVE)
Elli Oskey - Loyola University Chicago - Setter/OPP (Pineapple High Performance)
Lucy Ripley - Loyola University Chicago - MB/OPP (FC Elite)
Liana Edwards - University of Rhode Island - Setter/OPP (Maine Juniors)
Mia Diouf - Virginia Commonwealth University - OPP/OH (Game Point)

Atlantic Coast Conference (ACC):
Sophia Albaugh - Boston College - OH (OTVA)
Maddy Conner - Boston College - OPP (Spaceneedle)
Ruby Sampson - Boston College - MB (City)
Sophia Smith - Boston College - OPP (Legacy)
Lauren Tisler - Boston College - OH (One Wisconsin)
Destinee Chukelu - University of California, Berkeley - MB (A5)
Breya Dawson - University of California, Berkeley - OH/OPP (Memphis Metro)
Maura Hambly - University of California, Berkeley - OH (Vision)
Emma Kingston - University of California, Berkeley - MB (WAVE)
Kaelyn Bjorklund - Clemson University - Setter/OPP (Northern Lights)
Kylee Evans - Clemson University - MB (A5)
Bryn Meyer - Clemson University - OH (Legacy)
Cynthia Ockerman - Clemson University - MB (Legacy)
Caelyn Whosendove - Clemson University - OH (A5)
Ella Horvick - Duke University - Libero/DS (OTVA)
Hailey Mueller - Duke University - OH/DS (Triangle)
Amelia Mullen - Duke University - Setter/OPP (OK Charge)
Evie Pool - Duke University - MB (Forza1)
Ashlyn Quiri - Florida State University - OH (Arizona Sky)
Mollie VanDeusen - Florida State University - OPP (Jacksonville Juniors)
Elizabeth Bower - University of Louisville - Libero/DS (Idaho Crush)
Carsyn Comer - University of Louisville - MB (Munciana)
Keilani Ledaja-Brewer - University of Louisville - OH (Triangle)
Camille Csernik - University of Miami - OH (TAV Houston)
May Durrill - University of North Carolina - MB (High Performance STL)
Kalia Kroth - University of North Carolina - OH/DS (1st Alliance)
Marlie Smith - University of North Carolina - Setter (Legacy)
Rory Boyle - North Carolina State University - MB (TLVC)
Alex Brenner - North Carolina State University - OH (International: Canada)
Jordyn Lehman - North Carolina State University - Libero/DS (Winter Park)
Tristyn Bailey - University of Notre Dame - OH (Mizuno Long Beach)
Olivia Orosz - University of Notre Dame - Setter (International: Canada)
Lauren Sprague - University of Notre Dame - OH/DS (Madtown Juniors)
Sarah Stegall - University of Notre Dame - OH (Pineapple High Performance)
Peyton Kubik - University of Pittsburgh - OH (Dynasty)
Kyla Williams - University of Pittsburgh - MB (AVC)
Brynn Stephens - Southern Methodist University - OH (TAV)
Caroline Ward - Southern Methodist University - OPP (Circle City)
Hayden Curtis - Syracuse University - Setter (Dallas Skyline)
Layla Dunn - Syracuse University - OPP (A5)
Candice Holloway - Syracuse University - MB/OPP (No Name)
Amelia Snider - Syracuse University - OH/OPP (OTVA)
Camryn Coulther - University of Virginia - Libero/DS (VA Juniors)
Jade Howard - University of Virginia - MB (A5)
Coco Lewis - University of Virginia - OH (VA Juniors)
Sarah MacDonald - University of Virginia - Libero/DS (Tstreet)
Kyla Mitchell - University of Virginia - MB (Michio Chicago)
Piper Lee - Virginia Tech - Libero/DS (Alabama Performance)
Mo Wiezorek - Virginia Tech - Setter (Rockwood Thunder)
Addison Kelenic - Wake Forest University - MB (Milwaukee Sting)
Isabella Lopez - Wake Forest University - OPP (Tribe)
Trinity McCormick - Wake Forest University - Setter (Tribe)
Gabby McLaughlin - Wake Forest University - Libero/DS (A5)

Atlantic Sun Conference (ASUN):
Lilah Laaper - Austin Peay State University - Setter (Mintonette)
Avery Ralston - Austin Peay State University - OH (Austin Juniors)
Isabel O'Brien - Bellarmine University - OH (Tri-State Elite)
Lyric Judson - Florida Gulf Coast University - MB/OH (Premier Nebraska)
Anniston Clark - Lipscomb University - MB (KC Power)
Elleora Utecht - Lipscomb University - OH (Northern Lights)
Ava Beasley - University of North Alabama - OH/Setter (Memphis Juniors)
Emmerson Rehkopf - University of North Alabama - OH (Ozark Juniors)
Aliah Earls - University of North Florida - MB/OPP (Dallas Premier)
Aubree Pratt - University of North Florida - OPP (Dallas Skyline)
Bella Burk - Queens University of Charlotte - Setter (Alliance)
Grace Schneekloth - Stetson University - OH (TAV)

Big 12 Conference:
Nylah Bibby - University of Arizona - OH (AZ Storm)
Londyn Pope - University of Arizona - MB (Dallas Premier)
Asia Udo-Ema - University of Arizona - OH (Forza1)
Tinsley Welker - University of Arizona - Setter (Houston Skyline)
Isabell Scheuch - Arizona State University - MB (Minnesota Select)
Kacie Schulte - Arizona State University - OH/OPP (Northern Lights)
Natalie Kitts - Baylor University - MB/OPP (Houston Juniors)
Jaycee Mack - Baylor University - OH (WAVE)
Sophia Puleo - Baylor University - OH/OPP (OTVA)
Aubrey Burns - Brigham Young University - Libero/DS (Arizona Sky)
Jadyn Clinkscale - Brigham Young University - MB (East Coast Crush)
Katherine McDonald - Brigham Young University - Setter (Red Storm)
Jaylynn Carter - University of Central Florida - OH/OPP (Carolina Union)
Yahya Johnson - University of Central Florida - MB (Vero Elite)
Presley Kreter - University of Central Florida - MB (Performance Volleyball Academy)
Anabelle Schembra - University of Central Florida - Setter (Circle City)
Teagan Kondik - University of Cincinnati - OH/OPP (NKYVC)
Payton Beard - University of Colorado - OH (AVC)
Aspen Brown - University of Colorado - OPP (Houston Skyline)
Mya Capistrano - University of Colorado - Libero/DS (Forza1 North)
Grace Pinegar - University of Colorado - OH (Dallas Skyline)
Sophia Austen - Iowa State University - OH (Iowa United)
Bella Cook - Iowa State University - MB (Shockwave)
Nia Fonoti - Iowa State University - Setter (Mintonette)
Piper Ladwig - Iowa State University - OH (Iowa Power Plex)
Logan Vogt - Iowa State University - OH (Iowa Power Plex)
Lyla Crowder - University of Kansas - MB (1United)
Lila Green - University of Kansas - Libero/DS (WAVE)
Marissa Jones - University of Kansas - Setter (A5)
Chandler Carter - Kansas State University - Libero/DS (TAV Houston)
Lydia Chinchar - Kansas State University - OPP (No Name)
Allison Toft - Kansas State University - MB (Iowa Select)
Alice Wood - Kansas State University - Setter (Lower Alabama)
Piper Chylinski - Texas Christian University - Setter/OPP (City)
Kaelynn Lottman - Texas Christian University - Libero/DS (VCNebraska)
Lexi Martin - Texas Christian University - OH (TAV)
Kristen Sheehy - Texas Christian University - MB (Rev Volleyball Academy)
Kenzie Brown - Texas Tech University - MB (Colorado Elite)
Lauren Bunge - Texas Tech University - MB (Northern Lights)
Karsyn Evans - Texas Tech University - Libero/DS (MadFrog)
Landry Roberts - Texas Tech University - OH (Colorado Juniors)
Caylee Young - Texas Tech University - Libero/DS (Houston Skyline)
Nafanua Alofipo - University of Utah - Setter (Club V)
MaKenna Corrie - University of Utah - Setter/OPP (Rev Volleyball Academy)
Abby Lemp - University of Utah - MB (Madfrog)
Delaney Wright - University of Utah - OH/DS (TAV Houston)
Brooklyn Sippio - West Virginia University - MB (Game Point)
KaVeaya Turner - West Virginia University - MB (Summit)

Big East Conference: 
Avary Brown - Butler University - Setter (AVC)
Mallory Harrison - Butler University - Libero/DS (Illini Elite)
Caroline Curry - University of Connecticut - Libero/DS (Northeast)
Aaliyah Green - University of Connecticut - OH (Paramount)
Allie Hudgins - Creighton University - OH (TAV)
Ruthie Robinson - Creighton University - MB (Kairos)
Reagan Wallraff - Creighton University - OH/MB (Nebraska One)
Laila Henry - DePaul University - Setter (Northeast)
Sawyer Lloyd - DePaul University - OH/OPP (South Texas Volleyball Academy)
Jocelyn Paige - DePaul University - MB (Carolina Union)
Caroline Wright - DePaul University - MB (Adversity)
Andie Bowron - Georgetown University - Setter (Top Select)
Haley Higgins - Georgetown University - MB/OPP (Top Select)
Avery Kapeller - Georgetown University - OH (High Performance Volleyball Academy)
Katherine Nowak - Georgetown University - OH (WAVE)
London Evans - Marquette University - Setter (Munciana)
Lola Robertson - Marquette University - OH (VC United)
Kenzie Maldonado - Seton Hall University - OH/MB (Club One AZ)
Breanna Benavides - Villanova University - Libero/DS (Austin Juniors)
Erin Cramer - Villanova University - MB/OPP (Premier Nebraska)
Riley Loehfelm - Villanova University - OH (FaR Out)
Jayda Palumbo - Villanova University - OH/OPP (Tribe)
Taylor Carroll - Xavier University - OH/OPP (1st Alliance)
Charley Moeddel - Xavier University - MB (Tri-State Elite)
Ali Strange - Xavier University - Libero/DS (Elevation)

Big Sky Conference:
Nevaeh Richardson - University of Idaho - OH/DS (Excel)
Eva Wall - Idaho State University - Libero/DS (Idaho Crush)
Ella Wilson - Idaho State University - MB (NORCO)
Addison Herber - University of Montana - MB/OPP (North Pacific Juniors)
Avery Herber - University of Montana - OH (North Pacific Juniors)
Jersey McCollum - University of Montana - Setter (Colorado Juniors)
Brooklyn Binford - Montana State University - Libero/DS (Big Sky)
Jayda Nothdurft - Montana State University - OH (NORCO)
Rachel Richardson - Montana State University - MB (NorCal)
Addison Bartnik - Northern Arizona University - MB/OPP (Aspire)
Rylan Keane - Northern Arizona University - OH/OPP (Club One AZ)
Ryan Libey - Northern Arizona University - MB (CPA)
Ashlyn Delaney - University of Northern Colorado - MB (Colorado Juniors)
Brooke Friesen - University of Northern Colorado - Setter/OPP (North Pacific Juniors)
Avery Smiley - University of Northern Colorado - Libero/DS (NORCO)
Kylee Webb - University of Northern Colorado - OH/OPP (Dynasty)

Big South Conference:
Bryce Berry - Charleston Southern University - OH/DS (KIVA)
Marley Angelucci - Gardner-Webb University - Setter (East Coast Power)
Samantha Chavis - High Point University - Setter/OPP (Triangle)
Avery Abrams - Radford University - MB (Carolina Rogue)
Campbell Davis - Radford University - OH (Queen City)
Dallyn Haupt - University of South Carolina Upstate - OH/OPP (Memphis Juniors)
Hannah Huggins - University of South Carolina Upstate - MB (Carolina Select)
Milena Miladinovic - Winthrop University - MB (Houston Juniors)
Ellie Osowski - Winthrop University - OH (Northern Lights)

Big Ten Conference:
Westley Matavao - University of California, Los Angeles - OH (Forza1 North)
Hunter Ross - University of California, Los Angeles - MB (Metro)
Mia Lamberti - University of Illinois - Setter/OPP (Illini Elite)
Sofia Simic - University of Illinois - OH (Fight Club)
Cedra Talaga - University of Illinois - Libero/DS (Mizuno Long Beach)
Kaitlyn Herweg - Indiana University - Libero/DS (SCVC)
Samantha Karjala - Indiana University - OPP/OH (OTVA)
Emery Cardinal - University of Iowa - MB (Pineapple High Performance)
Carly Dawson - University of Iowa - OH (Illini Elite)
Mia Lavalle - University of Iowa - Libero/DS (Miami Hype)
Myah Koster - University of Maryland - OH (Coast)
Jordan Mitchell - University of Maryland - MB (Austin Performance)
Luca Bombacino - University of Michigan - OH (Michio Chicago)
Maggie Kurpeikis - University of Michigan - OH (Adversity)
Kiersten Moore - University of Michigan - Setter (Forza1)
Sanai Severloh - University of Michigan - MB (Forza1 North)
Cora Bicknese - Michigan State University - Libero/DS (Vital)
Ellery DeBoer - Michigan State University - Setter (Minnesota Select)
Lauren Forelli - Michigan State University - OH (Rev Volleyball Academy)
Mallory Wandel - Michigan State University - OH (Michigan Volleyball Academy)
McKinley Moser - University of Minnesota - Setter (VCNebraska)
Malorie Boesiger - University of Nebraska - Setter (Nebraska One)
Mallory Johnson - University of Nebraska - Libero/DS (FaR Out)
Hua Laikona - University of Nebraska - Libero/DS (AZ Storm)
Kendall Omoruyi - University of Nebraska - MB (City)
Shaye Witherspoon - University of Nebraska - OH (Rockwood Thunder)
Makenna Barnes - Northwestern University - OH/OPP (SC Rockstar)
Addie Knapke - Northwestern University - Libero/DS (Mintonette)
Miranda Knoll - Northwestern University - OH (Tribe)
Izzy Stojkovic - Northwestern University - OH (Aspire)
Ella Gravlee - Ohio State University - OH/OPP (Tribe)
Kate Kalczynski - Ohio State University - OH (Legacy)
Piper Hanson - University of Oregon - Libero/DS (North Pacific Juniors)
Madelynn Henry - University of Oregon - OH (Kairos)
Avery Masters - University of Oregon - MB (OMNI)
Nejari Crooks - Pennsylvania State University - OPP (Triad Elite)
Taylor Harrington - Pennsylvania State University - MB (Paramount)
Olivia Henry - Pennsylvania State University - OH (IMG Academy)
Molly Robertson - Pennsylvania State University - Setter (AVC)
Malia Rogers - Purdue University - OH (Six Pack)
Molly Drake - Rutgers University - OH (Jersey Juniors)
Allie Lindsey - Rutgers University - OH (Houston Juniors)
Logan Sanders - Rutgers University - Setter/DS (Austin Performance)
McKenna McIntosh - University of Southern California - OH (Vision)
Willtrace Ngoh - University of Southern California - MB (Houston Juniors)
Jillian Forrest - University of Washington - MB/OPP (Tri-State Elite)
Jazlyn Hepburn - University of Washington - MB/OH (Austin Performance)
Decelise Champion - University of Wisconsin - OPP (Puerto Rico)

Big West Conference:
Payton Davis - California Baptist University - Setter (Waco Juniors)
Emerson Ortiz - California Baptist University - Setter (AZ Storm)
Eva Kate Simoncic - California Baptist University - OPP (Houston Juniors)
Anaiya Thornton - University of California, Irvine - OH (SC Rockstar)
Kennedy Lee - University of California, Santa Barbara - Setter/DS (Hawaii Next Level)
Kat Wulff-Smith - University of California, Santa Barbara - Libero/DS (Dartfrog)
Lily Beckwith - California State University, Long Beach - OH (Northern Nevada Juniors)
Genesis Botts - California State University, Long Beach - MB (Forza1 North)
Saaliyah Brown - California State University, Long Beach - MB/OPP (Forza1 North)
Kate Colosky - California State University, Long Beach - MB (FaR Out)
Gia Ireland - California State University, Northridge - Setter (NORCO)
Analiah Lauifi - California State University, Northridge - Libero/DS (Dakine)
Sydney Neely - California State University, Northridge - OPP/OH (SCVC)
Lily Smith - California State University, Northridge - OPP (Synergy Force)
Sienna Cathey - California Polytechnic State University - OH/OPP (Arizona Sky)
Peyton Frederick - California Polytechnic State University - OPP (Puget Sound Volleyball Academy)
Kylee Mark - California Polytechnic State University - Setter (Mountain View)
MaryElla Owens - California Polytechnic State University - OPP/MB (Aspire)
Layla Steinfeld - California Polytechnic State University - OH/OPP (Coast)
Lexi Brown - Utah Valley University - OH (Elevate Athletics)
Lyla McClure - Utah Valley University - Setter/DS (Idaho Crush)
Whitney Port - Utah Valley University - MB (Tstreet)

Coastal Athletic Association (CAA):
Gianna Burke - Campbell University - OPP (A5)
Kamryn Mullican - Campbell University - Setter/OPP (Drive Nation)
Lila Bruszewski - College of Charleston - OH/MB (The Academy)
Caroline Smith - College of Charleston - MB/OPP (NC Volleyball Academy)
Lily Tripi - College of Charleston - Setter (Michigan Elite)
Chloe Abbott - Elon University - MB/OPP (NC Volleyball Academy)
Marley Edson - Elon University - Setter/OPP (High Performance Illinois)
Aubree Frazier - Elon University - OH/OPP (Mintonette)
Livie Stevens - Elon University - OPP/OH (MAVS KC)
Maryn Dean - North Carolina A&T State University - Setter (MAVS KC)
Norah Davis - University of North Carolina Wilmington - OH (NC Volleyball Academy)
Ally Forbes - University of North Carolina Wilmington - OH/DS (Triangle)
Elizabeth Hackleman - Northeastern University - Setter/OPP (East Valley Juniors)
Kendall Anderson - Northeastern University - MB (Colorado Juniors)
Daniela Matznick - Northeastern University - Libero/DS (IMG Academy)
Sophia Phung - Stony Brook University - OH (International: Canada)
Audrey Hedlund - College of William & Mary - MB (Austin Juniors)

Conference USA:
Alexa Bracey - University of Delaware - OPP/MB (Paramount)
Gabby McHenry - Florida International University - OH/OPP (Madfrog)
Brooklyn Rummler - Florida International University - MB (Legacy)
Hannah Sawtelle - Florida International University - MB/OPP (Austin Juniors)
Jasmin Tucker - Hampton University - OH/OPP (Metro)
Tessa Dobmeier - Liberty University - OPP (SCVC Rockstar)
Hadley Kelly - Liberty University - MB (Lower Alabama)
Kennedy Krueger - Liberty University - OH/DS (TKVBC)
Kaleigh Langmo - Liberty University - OH (Top Select)
Lauren Garcia - Louisiana Tech University - Setter (Austin Performance)
Skylar Towner - Louisiana Tech University - MB/OPP (Red Storm)
Kherynton Chinnis - Middle Tennessee State University - MB (Drive Nation)
Sophie Payne - Middle Tennessee State University - OH (OK Charge)
Kate Sherry - Middle Tennessee State University - OH (High Performance STL)
Payton Abalos - New Mexico State University - OH (East Valley Juniors)
Ava Price - New Mexico State University - Setter (TX Performance)
Justice Rachal - Sam Houston State University - OH (TAV Houston)
Layla Green - Western Kentucky University - MB (MAVA)
Madelynn Yates - Western Kentucky University - OH (MAVA)

Horizon League:
Ella Laskowski - Indiana University Indianapolis - OH/OPP (NIVA)
Bobbi Wire -  Indiana University Indianapolis - OH (Sky High)
Makenna Meibers - Northern Kentucky University - OH (Tri-State Elite)
Brenna Mirovsky - Oakland University - Libero/DS (Michigan Elite)
Kendall Dahlen - University of Wisconsin-Milwaukee - Libero/DS (Northern Lights)
Reese Maslowski - University of Wisconsin-Milwaukee - OH/DS (MAVS KC)
Ainsley Aten - Wright State University - Libero/DS (Dynasty)
Mia Jasgarszewski - Wright State University - Setter (MAVA)
Maya Flores - Youngstown State University - OH/MB (Cleveland Volleyball Academy)

Ivy League:
Emma Elbert - Brown University - Setter/OPP (Revolution Volleyball Academy)
Evie Igbenebor - Brown University - MB (Performance Volleyball Academy)
Sophia Gao - Columbia University - Libero/DS (Sudden Impact)
Delaney Klunder - Columbia University - OH (Sunshine)
Mia Bell - Cornell University - MB (Triangle)
Kate Bickel - Cornell University - Libero/DS (Virginia Juniors)
Giselle Stoeva - Cornell University - OPP/OH (High Performance STL)
Rylee Jewell - Dartmouth College - Libero/DS (Elevation)
Kayah Armstrong - Harvard University - MB (Northeast)
Margaux Godfrey - Harvard University - Libero/DS (A5)
Bergen Stiff - Harvard University - OH (Kairos)
Sofia Cubeddu - University of Pennsylvania - Libero/DS (IMG Academy)
Sophia Cotter - Princeton University - OPP (Sunshine)
Siena Ebert - Princeton University - Libero/DS (TAV)
Alexa Grossman - Princeton University - Setter (A5)
Lucy Tusher - Princeton University - Libero/DS (Absolute)
Allie Breitling - Yale University - OH (Vegas Aces)
Madara Bungs - Yale University - OH (East Coast Power)
Kaylee Foreman - Yale University - Libero/DS (Tribe)
Sasha Francis - Yale University - OH (A5)
Jocelyn Gill - Yale University - MB (Metro)

Metro Atlantic Athletic Conference (MAAC):
Maya Gray - Iona University - MB/OPP (No Name)
Kelsie Smith - Marist University - Setter (Mintonette)

Mid-American Conference (MAC):
Laine Thompson - University of Akron - Setter (Illini Elite)
Kerrington Corbin - Ball State University - MB (Alliance)
Hayden Mandsager - Ball State University - OH (Rev Volleyball Academy)
Aubrey Martinez - Ball State University - Libero/DS (1st Alliance)
Macy Melville - Ball State University - OH (Club 801)
Ava Bush-Nelson - Bowling Green State University - MB/OPP (FaR Out)
Ryah Cotton - Bowling Green State University - Setter/OPP (Northern Lights)
Charley Gardner - Bowling Green State University - OH (Legacy)
Kendyl Strack - Bowling Green State University - Libero/DS (Academy)
Kylie Trout - Bowling Green State University - Libero/DS (Elite VBTC)
Gabby Kumagai - Eastern Michigan University - Libero/DS (SCVC)
Klarke Mosby - Eastern Michigan University - OPP (1st Alliance)
Kendall Hubbard - Miami University - Setter (Elevation)
Freya McBride - Miami University - Libero/DS (Adversity)
Jacleyn Zgonc - Miami University - OH (RockCity)
Elle Mortimer - Ohio University - MB (Mintonette)
Lizzie Risdon - Ohio University - DS/OH (FaR Out)
Emerson Moser - University of Toledo - Libero/DS (Tri-State Elite)
Khloe Nelson - University of Toledo - OH (Premier Academy)
Taylor Berg - Western Michigan University - OH/DS (1st Alliance)
Makayla Naves - Western Michigan University - Libero/DS (Legacy)

Missouri Valley Conference:
Jordyn Jones - Belmont University - OH/DS (Michigan Elite)
Camille Northcross - Belmont University - OH/DS (Memphis Metro)
Lola Waleskowski - Belmont University - OPP/OH (NKYVC)
Nancy Ward - Bradley University - MB (Memphis Metro)
Leah Janulewicz - Drake University - Libero/DS (Iowa Power Plex)
Campbell Capece - University of Evansville - Libero/DS (Premier Nebraska)
Charlie Fleegle - Illinois State University - Libero/DS (Sky High)
Kyla Ramler - Illinois State University - MB (Iowa Select)
Dannah Kerberg - Indiana State University - Libero/DS (KIVA)
Annabelle Bischoff - University of Northern Iowa - MB (Illini Elite)
Bo Bronson - University of Northern Iowa - OH (KC Power)
Eden Hafermann - University of Northern Iowa - OH (Illini Elite)
Gwen Farley - Valparaiso University - Setter (Iowa PowerPlex)

Mountain West Conference:
Miette Moon-Sasik - University of California, Davis - Setter (Actyve)
Kail Shill - University of California, Davis - Setter (Aspire)
Jillian Deatherage - Grand Canyon University - MB (Idaho Crush)
Reina Jones - University of Nevada, Las Vegas - Setter (Houston Juniors)
Isabel Harden - San Jose State University - OH/DS (Tsunami)
Mackenzi Law - San Jose State University - MB/OPP (TAV)
McKenna Satterfield - San Jose State University - Setter (Idaho Crush)
Sasha Keys - University of Texas at El Paso - Setter (TAV Houston)
Holland Hutchins - United States Air Force Academy - OPP (Dallas Skyline)
Alisi Tapa'atoutai - United States Air Force Academy - MB (Club V)
Emery Johnson - University of Wyoming - OH (NORCO)

Northeast Conference:
Bri Pickett - Stonehill College - OH (Alamo)

Ohio Valley Conference:
Ella Miller - Morehead State University - OH (Boiler Juniors)
Emily Williams - University of Southern Indiana - Setter (The Academy)
Riley Woods - Tennessee Technological University - Libero/DS (NASA)

Pac-12 Conference:
Jula Utash - Boise State University - OH/DS (AZ Storm)
Cassidy Armstrong - California State University, Fresno - Setter (Arizona Sky)
Shannara Peebles - California State University, Fresno - OH (Washington Volleyball Academy)
Ella Rowe - California State University, Fresno - MB/OH (Valley Volleyball Academy)
Brenna Walsh - California State University, Fresno - Libero/DS (AZ Storm)
Kenzie Smith - Colorado State University - Libero/DS (OK Charge)
Margaret Foote - Gonzaga University - MB/OPP (Sudden Impact)
Natalie Norton - Gonzaga University - OH (Drive Nation)
Molly Scout Weston - Gonzaga University - MB/OPP (Oregon Juniors)
Marley Bemus - Oregon State University - Setter (Coast)
Abbie Hairrell - Oregon State University - MB (SCVC)
Gentry Barker - San Diego State University - OH (Austin Performance)
Bella Howard - San Diego State University - MB (Madfrog)
Zaley Madkin - San Diego State University - OH (Infinity Volleyball Academy)
Lila Ellsworth - Utah State University - OH/OPP (AZ Storm)
Klancee Larsen - Utah State University - MB (Club V)
Dakota Richard - Utah State University - Setter (Madfrog)
Estelle Slaney - Utah State University - Libero/DS (Club V)
Leah Thomas - Utah State University - OH (Idaho Crush)
Audrey White - Utah State University - OH (Mountain Peak)
Bailey Lambert - Washington State University - MB (Rev Volleyball Academy)
Addy Nicks - Washington State University - OH/OPP (Rev Volleyball Academy)
Logan Pecht - Washington State University - MB (CPA)
Kaitlyn Vogel - Washington State University -  Libero/DS (Vision)

Patriot League:
Farryn Burridge - American University - MB (1st Alliance)
Alexa Telly - American University - OH (Metro)
Emma Ormsby - Colgate University - OH (Big Sky)
Esther Royal-Priest - Colgate University - OH (San Antonio Juniors)
Sasha Selivan - Colgate University - Setter (SMASH)
Cora Thomas - Colgate University - MB (M2)
Natasha Macau - Lehigh University - Setter/OPP (Miami Volleyball Academy)
Riley Caruso - United States Military Academy - Setter (Carolina Union)
Lauren Green - United States Military Academy - OH (Forza1 North)
Mia Ray - United States Military Academy - OH/DS (A5)
Emi Markovic - United States Naval Academy - OPP/Setter (SC Elite)
Marlee Schumacher - United States Naval Academy - MB/OPP (OTVA)
Ailanni Sellers - United States Naval Academy - Setter/OPP (OTVA Jax)

Southeastern Conference (SEC):
Fara Bronson - University of Alabama - Setter (AZ Storm)
Madysen Chime - University of Alabama - OPP (Houston Skyline)
Zania Haymond - University of Alabama - MB (Club 360)
Jordan Morrow - University of Alabama - OH (Houston Skyline)
Addison Thompson-Stepp - University of Alabama - Libero/DS (Legacy)
Gemma Hopkins - University of Arkansas - Libero/DS (Houston Juniors)
Evelyn Venters - University of Arkansas - MB (Ozark Juniors)
Jenna Brooks - Auburn University - Libero/DS (Top Select)
Sasha Cromer - Auburn University - Setter (KC Power)
Kampbell Niepagen - Auburn University - OH (Sports Performance)
Amelia Albright - University of Florida - Setter (Austin Juniors)
Lyla Huggins - University of Florida - Libero/DS (Ocala Power United)
Elly Randolph - University of Kentucky - OH (NC Volleyball Academy)
Saniya Reynolds - University of Kentucky - OH/MB (Houston Juniors)
Shania Rhamy - University of Kentucky - OH/DS (Munciana)
Kennedy Varda - University of Kentucky - MB (Big Sky)
Sophia Dostic - Louisiana State University - Setter (OTVA)
Naomi Livings - Louisiana State University - OPP (TAV)
Nyla Livings - Louisiana State University - MB (TAV)
Nailah Randle - Louisiana State University - OPP/OH (San Antonio Juniors)
Ryann Bothof - University of Mississippi (Ole Miss) - Libero/DS (Club 757)
Addison Harris - University of Mississippi (Ole Miss) - OH/OPP (Memphis Metro)
Maria Herron - University of Mississippi (Ole Miss) - OH/OPP (Waco Juniors)
Reese Meier - University of Mississippi (Ole Miss) - OPP (Idaho Crush)
Addyson Avery - Mississippi State University - MB (Ocala Power United)
Kendall Brown - Mississippi State University - OH (Memphis Metro)
Sullivan Todd - Mississippi State University - Setter (Alabama Performance)
Maizy Agnello - University of Missouri - OH (Sky High)
Eve Bushnell - University of Missouri - OH/OPP (NC Volleyball Academy)
Lucky Fasavalu - University of Missouri - Setter (Mizuno Long Beach)
Danielle Lewis - University of Missouri - Libero/DS (Carolina Union)
Marlee Steiner - University of Missouri - MB (High Performance STL)
Aniyah Baker - University of Oklahoma - OH/MB (Austin Juniors)
Laila Chadwick - University of Oklahoma - Libero/DS (Metro)
Sitoafa Tausinga - University of Oklahoma - OH (Club V)
Laura Adel - University of South Carolina - Setter (International: Canada)
Riley Riggs - University of South Carolina - OH (Dynasty)
Graceyn Shepard - University of South Carolina - Libero/DS (Triangle)
Mara Sandberg - University of Tennessee - OH (CPA)
Ella Olson - University of Texas - OH/DS (Tstreet)
Camille Presley - University of Texas - MB (Austin Performance)
Ireland Real - University of Texas - OH (WAVE)
Isabel Incinelli - Texas A&M University - OH/MB (Winter Park)
Braelyn Patton - Texas A&M University - MB/OH/OPP (Dallas Premier)
Sophee Peterson - Texas A&M University - Setter (TAV)
Annika Dandridge - Vanderbilt University - OH (Paramount)
Gracie Hobin - Vanderbilt University - MB/OH (Houston Skyline)
Mia Kinney - Vanderbilt University - Libero/DS (K2)

Southern Conference (SoCon):
Hailey Hinrichsen - East Tennessee State University - MB (Front Range)
Camille Robinson - East Tennessee State University - OH (FaR Out)
Kennedy Langmo - Furman University - OH (Top Select)
Addie Bollier - Samford University - Libero/DS (Iowa United)
Addison Hurley - Samford University - Setter (KIVA)
Khyler Reed - Western Carolina University - Setter (No Name)
Olivia Badyna - Wofford College - Libero/DS (OTVA)
Anne Gregory Herren - Wofford College - OH (A5)
Lily Keeley - Wofford College - MB (OTVA)
Marley Moore - Wofford College - OPP/OH (A5)
Camryn Penn - Wofford College - Setter (Dallas Skyline)

Southland Conference:
Allison Luke - East Texas A&M University - OH/OPP (MoCo Mavs)
Addison Yendrey - East Texas A&M University - MB (Corpus Christi Force)
Julia Hudgins - Lamar University - OH (Arete)
Bree Mills - Northwestern State University - MB (N/A)
Payton Oliver - Northwestern State University - Libero/DS (Houston Stellar)
Aubrey Frey - Stephen F. Austin State University - OH/DS (FC Elite)
Sarah Grace Hickl - Stephen F. Austin State University - OH/OPP (Houston Stellar)
Rylee Schimelpfening - Stephen F. Austin State University - Setter (Queen City)
Brooke Toliver - Stephen F. Austin State University - MB (MoCo Mavs)
Alondra Nye-Col√≥n - Texas A&M University-Corpus Christi - Libero/DS (Peak Volleyball Academy)
Anaya Peel - Texas A&M University-Corpus Christi - MB/OPP (East Texas Alliance)
Kerington Thornton - Texas A&M University-Corpus Christi - MB (Austin Juniors)
Landri Trice - Texas A&M University-Corpus Christi - OH (TAV)

Southwestern Athletic Conference (SWAC):
Mariah Brown - University of Arkansas, Pine Bluff - Setter/OPP (MoCo Mavs)
Azaria Ehima - Florida A&M University - OPP (A5)
Tamarria Mitchell - Florida A&M University - OH (Houston Skyline)
Alex Walker - Texas Southern University - Libero/DS (Vegas Aces)

Summit League:
Aubree Fettin - University of Nebraska Omaha - Libero/DS (Nebraska One)
Taylor McLeay - University of Nebraska Omaha - DS/OH (Premier Nebraska)
Emilee Thayer-Mencke - University of Nebraska Omaha - OPP (Nebraska One)
Lily Mather - University of North Dakota - OH (North Pacific Juniors)
Lochlar O'Bleness - University of North Dakota - Libero/DS (MAVS KC)
Katherine Anderson - University of South Dakota - MB (Minnesota Select)
Halle Laincz - University of South Dakota - OPP (KC Power)
Taylor Peterson - University of South Dakota - Libero/DS (Northern Lights)
Ava Waters - University of South Dakota - Setter (Premier Nebraska)
Alli Bornschlegl - South Dakota State University - OH (VCNebraska)
Alyssa Gray - South Dakota State University - MB (Milwaukee Sting)
Meghan McCarthy - South Dakota State University - Setter (Minnesota Select)
Mya VanWesten - South Dakota State University - Libero/DS (Kairos)
Lainey Barnett - University of St. Thomas - MB/OPP (MAVS KC)
Leah Biyadglign - University of St. Thomas - Setter (Northern Lights)
Nicalai Eismann - University of St. Thomas - OH/DS (Milwaukee Sting)
Abby Miller - University of St. Thomas - Libero/DS (Kokoro)
Kayla Nawrocki - University of St. Thomas - Setter (Crossfire)
Mady Reesman - University of St. Thomas - MB (Milwaukee Sting)
Greta Schreiber - University of St. Thomas - OPP (Milwaukee Sting)

Sun Belt Conference:
Anne Culkar - Appalachian State University - OH (AVC)
Emilie Smith - Appalachian State University - OPP (Valley Volleyball Academy)
Lilly Tierney - Appalachian State University - MB/OPP (NKYVC)
Peyton Heatherly - Coastal Carolina University - Setter (1st Alliance)
Daniella Hopp - Coastal Carolina University - OH/DS (Club Fusion)
Kenzie Wilkie - Coastal Carolina University - Libero/DS (A5)
Kamryn Cocherl - Georgia Southern University - OH/OPP/MB (Mintonette)
Madelyn Faulkner - Georgia Southern University - Libero/DS (KIVA)
Kira Morin - Georgia Southern University - MB/OPP (Carolina Union)
Heidi Green - James Madison University - Libero/DS (Alliance)
Isabella Meekins - James Madison University - MB (Premier Volleyball of Delaware)
Macie Murray - James Madison University - OH (Metro)
Sydney Crowder - University of Louisiana at Lafayette - MB (Houston Skyline)
Milan Scanlan - University of Louisiana at Lafayette - Setter (Spike & Serve)
Kiersten Cieslinski - Marshall University - MB (Sky High)
Addie Doak - Marshall University - Libero/DS (Boiler Juniors)
Reagan Lyons - Marshall University - OPP/OH (Pineapple High Performance)
Keelyn Green - Old Dominion University - Setter/OH (Dallas Premier)
Alyssa Kumah - Old Dominion University - MB (Paramount)
Mackenzie Ratcliff - Old Dominion University - OH/MB (Excel)
Julie Roberts - University of South Alabama - OPP/OH (Alabama Performance)
Baylor Cauley - University of Southern Mississippi - Setter (Infinity Volleyball Academy)
Maci Jones - University of Southern Mississippi - OH (Emerald Coast)
Sullivan Lell - University of Southern Mississippi - Libero/DS (Alabama Performance)
Jordynn Taylor - Texas State University - MB (San Antonio Juniors)
Nya White - Texas State University - OPP (Corpus Christi Force)
Aubrey Duttlinger - Troy University - OH (VC United)
Avery Stewart - Troy University - MB/OH (Michigan Elite)
Ashley Troxell - Troy University - OH (A5)

United Athletic Conference (UAC):
Keira Caldwell - Abilene Christian University - MB/OPP (Rev Volleyball Academy)
Kaycin Farrell - Abilene Christian University - MB/OH (East Texas Juniors)
Olivia Permenter - University of Central Arkansas - OH/OPP (1United)
Kalei Davis - Tarleton State University - MB/OPP (360 Volleyball Club)
Kadence Dumas - Tarleton State University - OPP/OH (Memphis Metro)
Malia McNeal - Tarleton State University - Setter (Dallas Premier)
Cayleigh Monson - Tarleton State University - Libero/DS (San Antonio Force)
Talia Nelson - Tarleton State University - OPP (TAV Houston)
Rylin Otto - Tarleton State University - OH/OPP (Madfrog)

West Coast Conference (WCC):
Laven Blumoff - University of Denver - Libero/DS (Austin Juniors)
Anya Baklenko - Loyola Marymount University - Setter/DS (Madfrog)
Carson Caraway - Loyola Marymount University - OH (Infinity Volleyball Academy)
Jordan Flodder - Loyola Marymount University - OPP (1United)
Tessa Nover-Estes - Loyola Marymount University - Setter (Performance Volleyball Academy)
Ansley Shafer - Loyola Marymount University - Libero/DS (TAV)
Nola Wallace - Loyola Marymount University - MB (Aspire)
Bradee Boyd - Pepperdine University - OH/OPP (Tribe)
Piper McFadden - Pepperdine University - Setter (Colorado Juniors)
Sadie Wahlin - Pepperdine University - MB (AZ Storm)
Zamari Christensen - Saint Mary's College of California - Setter (Club V)
Berkley France - Saint Mary's College of California - OH (Arizona Sky)
Hayes Haan - Saint Mary's College of California - OPP (AZ Storm)
Brynn Barry - University of San Diego - Libero/DS (Sunshine)
Makayla Ziegler - University of San Diego - OH/OPP (Tstreet)
Bella Borgio - Santa Clara University - OH (Mintonette)
Emery Gonzales - Santa Clara University - Setter (WAVE)
Kaylie Klein - Santa Clara University - OH (Roots Volleyball Academy)